AclI	AACGTT	AA/CGTT
HindIII	AAGCTT	A/AGCTT
SspI	AATATT	AAT/ATT
MluCI	AATT	/AATT
PciI	ACATGT	A/CATGT
AgeI	ACCGGT	A/CCGGT
MluI	ACGCGT	A/CGCGT
HpyCH4IV	ACGT	A/CGT
SpeI	ACTAGT	A/CTAGT
BglII	AGATCT	A/GATCT
AfeI	AGCGCT	AGC/GCT
AluI	AGCT	AG/CT
StuI	AGGCCT	AGG/CCT
ScaI	AGTACT	AGT/ACT
ClaI	ATCGAT	AT/CGAT
NsiI	ATGCAT	ATGCA/T
AseI	ATTAAT	AT/TAAT
SwaI	ATTTAAAT	ATTT/AAAT
MfeI	CAATTG	C/AATTG
PmlI	CACGTG	CAC/GTG
PvuII	CAGCTG	CAG/CTG
NdeI	CATATG	CA/TATG
NlaIII	CATG	CATG/
FatI	CATG	/CATG
NcoI	CCATGG	C/CATGG
XmaI	CCCGGG	C/CCGGG
SmaI	CCCGGG	CCC/GGG
SacII	CCGCGG	CCGC/GG
MspI	CCGG	C/CGG
AvrII	CCTAGG	C/CTAGG
SbfI	CCTGCAGG	CCTGCA/GG
PvuI	CGATCG	CGAT/CG
BstUI	CGCG	CG/CG
EagI	CGGCCG	C/GGCCG
BsiWI	CGTACG	C/GTACG
BsmBI	CGTCTC	CGTCTC
BfaI	CTAG	C/TAG
PaeR7I	CTCGAG	C/TCGAG
PstI	CTGCAG	CTGCA/G
AflII	CTTAAG	C/TTAAG
EcoRI	GAATTC	G/AATTC
ZraI	GACGTC	GAC/GTC
AatII	GACGTC	GACGT/C
SacI	GAGCTC	GAGCT/C
Eco53kI	GAGCTC	GAG/CTC
EcoRV	GATATC	GAT/ATC
DpnI	GATC	GA/TC
MboI	GATC	/GATC
SphI	GCATGC	GCATG/C
SrfI	GCCCGGGC	GCCC/GGGC
NgoMIV	GCCGGC	G/CCGGC
NaeI	GCCGGC	GCC/GGC
AsiSI	GCGATCGC	GCGAT/CGC
HinP1I	GCGC	G/CGC
HhaI	GCGC	GCG/C
BssHII	GCGCGC	G/CGCGC
NotI	GCGGCCGC	GC/GGCCGC
BmtI	GCTAGC	GCTAG/C
NheI	GCTAGC	G/CTAGC
BamHI	GGATCC	G/GATCC
HaeIII	GGCC	GG/CC
FseI	GGCCGGCC	GGCCGG/CC
KasI	GGCGCC	G/GCGCC
NarI	GGCGCC	GG/CGCC
SfoI	GGCGCC	GGC/GCC
PluTI	GGCGCC	GGCGC/C
AscI	GGCGCGCC	GG/CGCGCC
PspOMI	GGGCCC	G/GGCCC
ApaI	GGGCCC	GGGCC/C
KpnI	GGTACC	GGTAC/C
Acc65I	GGTACC	G/GTACC
RsaI	GTAC	GT/AC
CviQI	GTAC	G/TAC
BstZ17I	GTATAC	GTATAC
SalI	GTCGAC	G/TCGAC
ApaLI	GTGCAC	G/TGCAC
HpaI	GTTAAC	GTT/AAC
PmeI	GTTTAAAC	GTTT/AAAC
SnaBI	TACGTA	TAC/GTA
BspHI	TCATGA	T/CATGA
BspEI	TCCGGA	T/CCGGA
TaqI	TCGA	T/CGA
NruI	TCGCGA	TCG/CGA
XbaI	TCTAGA	T/CTAGA
BclI	TGATCA	T/GATCA
HpyCH4V	TGCA	TG/CA
FspI	TGCGCA	TGC/GCA
MscI	TGGCCA	TGG/CCA
BsrGI	TGTACA	T/GTACA
MseI	TTAA	T/TAA
PacI	TTAATTAA	TTAAT/TAA
PsiI	TTATAA	TTA/TAA
BstBI	TTCGAA	TT/CGAA
DraI	TTTAAA	TTT/AAA
